111111111111111
10000P0000000111111
10001000C0000111
10001100100001111111
1000E11C1C0001111
111111111111111
